45 35 35 35 35 35 35 35 35 35 35 35 35 35 35 35 35 35 35 35 35 35 35 35 35 35 35 35 35 35 35 46 33 33 33 33 33 33 33 33 33 33 33 45 35 35 35 35 35 46 
37 19 32 32 32 32 32 19 19 19 19 19 19 32 32 19 19 19 19 19 19 19 19 19 19 19 19 19 32 32 32 38 35 35 35 35 35 35 35 46 33 33 33 37 32 32 32 32 32 36 
37 19 32 32 0 0 0 0 0 19 19 19 32 32 32 19 19 19 19 19 19 19 19 19 19 19 19 19 19 19 32 32 19 19 19 19 19 19 32 36 33 33 33 37 32 19 19 19 32 36 
37 19 19 32 0 56 56 56 0 19 19 32 32 12 11 11 11 13 19 19 16 19 16 19 16 19 16 19 19 19 19 19 19 19 19 19 32 32 32 36 33 33 33 37 19 19 19 19 19 36 
37 19 19 32 0 56 56 56 0 19 19 32 19 63 6 8 9 10 19 19 15 19 15 19 15 19 15 19 19 19 19 19 18 19 19 32 32 32 32 36 33 33 33 37 19 19 19 19 19 36 
37 19 19 19 0 56 56 56 0 19 19 19 19 63 7 6 6 10 19 19 15 19 15 19 15 19 15 19 19 19 19 19 19 19 0 0 0 0 0 36 33 33 33 37 19 19 19 19 19 36 
37 19 19 19 0 0 19 0 0 19 19 19 19 63 6 6 6 10 19 19 15 19 15 19 15 19 15 19 19 19 19 19 19 19 0 56 56 56 0 36 33 33 33 37 19 19 19 19 19 36 
37 19 19 19 19 19 19 19 19 19 19 19 19 3 2 2 2 4 19 19 15 19 15 19 15 19 15 19 19 19 19 19 19 19 0 56 56 56 0 36 33 33 33 37 19 19 19 19 19 36 
37 19 19 19 19 19 19 19 19 19 19 19 19 19 19 19 19 19 19 19 15 19 15 19 15 19 15 19 19 19 19 19 19 19 19 56 56 56 0 36 33 33 33 43 41 61 56 62 41 44 
37 32 19 19 19 19 19 19 19 19 19 19 19 19 19 19 19 18 19 19 14 19 14 19 14 19 14 19 19 19 19 19 19 19 0 56 56 56 0 36 33 33 34 33 33 60 56 59 33 33 
37 32 32 19 19 19 19 19 19 19 19 19 19 19 19 19 19 19 19 19 19 19 19 19 19 19 19 19 19 19 19 19 19 19 0 56 56 56 0 36 33 33 33 33 33 60 56 59 33 33 
37 32 32 32 32 19 19 19 19 19 19 19 19 19 19 19 19 19 19 19 19 19 19 19 19 19 19 18 19 19 19 19 19 19 0 0 0 0 0 36 33 33 33 33 33 60 56 59 33 33 
37 32 32 32 32 32 19 32 32 32 32 19 19 19 19 19 19 19 19 19 19 19 19 19 19 19 19 19 19 19 32 40 41 41 41 41 41 41 41 44 33 33 33 33 33 60 56 59 33 33 
37 19 32 32 32 32 19 19 32 32 32 19 19 19 19 18 19 19 19 19 19 19 19 19 19 19 19 19 19 32 32 36 33 33 33 33 33 33 33 33 33 33 33 33 33 60 56 59 33 33 
37 19 32 32 32 32 32 19 32 19 19 19 19 19 19 19 19 19 19 19 19 19 19 19 19 19 19 19 32 32 32 36 33 33 33 33 33 33 33 33 33 33 33 33 33 60 56 59 33 34 
37 19 19 19 19 19 19 19 19 19 19 19 19 19 19 19 19 19 19 19 19 19 19 19 19 19 19 19 32 32 32 36 33 33 33 33 33 34 33 33 33 33 33 33 33 60 56 59 33 33 
37 19 19 19 32 32 32 19 19 19 32 32 32 19 19 19 19 19 19 19 19 19 19 19 19 19 19 19 32 32 32 36 33 33 33 33 33 33 33 33 33 33 33 33 34 60 56 59 33 33 
37 19 19 19 19 32 32 32 32 19 19 32 32 19 19 19 19 19 19 19 18 19 19 19 19 19 19 19 19 32 32 36 33 33 33 33 33 33 33 33 33 33 33 33 45 57 56 58 46 33 
37 19 19 19 19 32 32 32 32 32 19 19 19 19 19 19 19 19 19 19 18 19 19 19 19 19 19 19 19 19 19 38 35 35 35 35 35 35 35 35 35 35 35 35 39 19 19 19 36 33 
37 19 19 19 32 32 32 32 32 32 19 19 19 19 40 41 41 42 19 19 19 19 19 19 19 19 19 19 19 19 19 19 19 19 19 19 19 19 19 19 19 19 19 19 19 19 19 19 36 33 
37 19 19 32 32 32 32 32 19 19 19 19 40 41 44 33 45 39 19 19 19 19 19 19 19 19 19 19 19 19 19 19 19 19 19 19 19 19 19 19 19 19 19 19 19 19 19 19 36 33 
37 19 19 19 32 32 32 32 19 19 19 19 36 33 33 33 37 19 19 19 19 19 19 19 19 19 19 32 32 32 19 19 19 19 19 32 32 40 41 41 41 41 41 41 41 41 41 41 44 33 
37 19 19 19 32 32 32 32 19 19 19 32 38 35 35 35 39 19 19 19 19 19 19 19 19 19 32 32 32 32 19 19 19 19 19 32 32 36 33 33 33 33 33 33 33 33 33 33 33 33 
37 19 19 19 19 19 19 19 19 19 19 32 32 32 32 32 32 19 19 19 19 19 18 19 19 19 32 32 32 32 32 18 19 19 32 32 32 36 33 33 33 33 33 33 33 33 33 33 33 33 
37 19 19 19 19 19 19 19 19 19 19 19 32 19 19 19 19 19 19 19 19 19 19 19 19 19 19 32 32 32 19 19 19 19 32 32 18 36 33 33 33 33 33 33 33 33 33 33 33 33 
37 19 19 19 19 19 19 19 19 19 19 19 19 19 19 19 19 18 19 19 19 19 19 19 40 41 41 41 41 41 61 56 62 41 41 41 41 33 33 33 33 33 33 33 33 33 33 33 33 33 
37 19 19 19 19 19 19 19 19 19 19 19 19 19 19 19 19 19 19 19 19 19 19 19 36 33 33 33 33 33 60 56 59 33 33 33 33 33 33 33 33 33 33 33 33 33 33 33 33 33 
37 19 19 19 19 19 19 19 18 19 19 19 19 19 19 19 19 19 19 19 19 19 19 19 36 33 33 33 34 33 60 56 59 33 33 33 33 33 33 33 33 33 33 33 33 33 33 33 33 33 
37 19 19 19 19 19 19 19 19 19 19 19 19 19 19 19 19 19 19 19 19 19 19 19 36 33 33 33 33 33 60 56 59 33 33 33 33 33 33 33 34 33 33 33 33 33 33 34 33 33 
37 32 32 19 19 19 19 40 41 41 41 41 41 41 41 41 41 41 41 41 41 41 41 41 44 33 33 33 33 33 60 56 59 33 33 33 33 33 33 33 33 33 33 33 33 33 33 33 33 33 
37 32 19 19 19 19 32 36 33 33 33 33 33 33 33 33 33 33 33 33 33 33 33 33 33 33 33 33 45 35 57 56 58 35 46 33 33 33 33 33 33 33 33 33 33 33 33 33 33 33 
37 32 19 19 19 19 32 36 33 33 33 33 33 33 33 33 33 33 33 33 33 33 33 33 33 33 33 33 37 32 32 19 19 32 36 33 33 33 33 33 33 33 33 33 33 33 33 33 33 33 
43 42 19 19 19 19 32 36 33 33 33 33 45 35 35 35 35 35 35 46 33 33 33 33 33 33 33 33 37 32 19 19 19 32 36 33 33 33 34 33 33 33 33 33 33 33 33 33 33 33 
33 37 19 18 19 19 32 36 33 33 34 33 37 19 19 19 19 19 19 36 33 33 33 33 45 35 35 35 39 19 19 19 19 19 36 33 33 33 33 33 33 33 33 33 33 33 33 33 33 33 
34 37 19 19 19 32 32 36 33 33 33 33 37 19 19 19 19 19 19 36 33 33 33 33 37 32 32 32 19 19 19 19 19 19 36 33 33 33 33 33 33 33 33 33 33 33 33 33 33 33 
33 37 19 19 32 32 32 36 33 33 33 33 37 19 18 19 19 19 19 36 33 33 33 33 37 32 32 32 19 19 19 19 19 19 36 33 33 34 33 33 33 33 33 33 33 33 33 33 33 33 
33 37 19 32 32 32 32 36 33 33 33 33 37 19 19 19 18 19 19 38 35 35 35 35 39 32 32 19 19 19 19 19 19 19 38 35 46 33 33 33 33 33 33 33 33 33 33 33 33 33 
33 43 41 41 41 41 41 44 33 34 33 33 37 19 19 19 19 19 19 32 32 32 32 19 19 19 19 19 19 19 19 19 19 32 32 32 36 33 33 33 33 33 33 33 33 33 34 33 33 33 
33 33 33 33 33 33 33 33 33 33 33 33 43 41 41 42 19 19 19 32 32 32 32 19 19 19 19 19 19 19 19 19 32 32 32 32 36 33 33 33 33 33 33 33 33 33 33 33 33 33 
33 33 33 33 34 33 33 33 33 33 33 33 33 33 33 37 19 19 18 19 32 32 32 32 19 19 19 19 19 19 19 32 32 32 32 32 36 33 33 33 34 33 33 33 33 33 33 33 33 33 
33 33 33 33 33 33 33 33 51 54 54 52 35 35 35 39 19 19 19 19 19 32 19 19 19 19 19 19 19 19 32 32 32 32 32 32 36 33 33 33 33 33 33 33 33 33 33 33 33 33 
33 33 33 33 33 33 51 54 53 20 20 24 19 19 19 19 19 19 19 19 19 19 19 19 18 19 19 19 19 19 32 32 32 32 32 32 36 33 33 33 33 33 33 33 33 33 33 33 33 33 
33 34 33 33 33 33 28 20 20 20 20 23 19 19 19 19 19 19 19 19 19 19 19 19 19 19 19 19 19 19 19 19 19 19 19 19 36 51 54 54 54 54 52 33 33 33 33 33 34 33 
33 33 33 33 33 33 28 20 20 20 23 19 19 19 18 32 32 19 19 19 19 19 19 19 19 19 19 19 19 19 19 19 19 19 19 19 25 20 20 20 20 20 27 33 33 33 33 33 33 33 
33 33 33 33 33 51 53 20 20 24 19 19 19 32 32 32 32 32 32 19 19 18 19 19 19 19 19 19 19 19 26 47 47 47 47 47 20 20 20 20 20 20 27 33 33 33 33 33 33 33 
33 33 33 33 33 28 20 20 20 20 47 48 19 32 32 32 19 19 19 19 19 19 19 19 19 19 19 19 19 26 20 20 20 20 20 20 20 20 20 20 20 20 27 33 33 33 33 33 33 33 
33 33 33 33 33 28 20 20 20 20 20 24 19 19 19 19 19 19 19 19 19 19 19 19 19 19 26 47 47 20 20 20 20 20 20 20 20 20 20 20 20 20 27 33 33 33 34 33 33 33 
33 33 33 33 33 28 20 20 20 20 20 20 47 47 47 47 47 47 47 47 47 47 47 47 47 47 20 20 20 20 20 20 20 20 20 20 20 20 20 20 20 20 27 33 33 33 33 33 33 33 
33 33 33 33 33 28 20 20 20 20 20 20 20 20 20 20 20 20 20 20 20 20 20 20 20 20 20 20 20 20 20 20 20 20 20 20 20 20 20 20 20 20 27 33 33 33 33 33 33 33 
33 33 33 33 33 49 30 30 30 30 30 30 30 30 30 30 30 30 30 30 30 30 30 30 30 30 30 30 30 30 30 30 30 30 30 30 30 30 30 30 30 30 50 33 33 33 33 33 33 33 
